поскольку: поскольку
иметь: иметь имеют имеет
средство: средства средств
отличие: отличие
рэш: рэш
он: нему
рынок: рынками рынки рынком рынках рынке рынка рынок рынку
дивный: дивном
эффективно: эффективно
устроить: устроены
специалист: специалистом специалистов специалист специалиста
операция: операций операции операциях операциями операциям
конец: конце конца концов
резерв: резервах резервами резервы резервов
область: области
запретить: запретить
история: историю истории историй история
захотеть: захочет
также: также
бесить: бесят бесит
счётный: счетная
цензура: цензуре
кнр: кнр
дать: дать данной данная дали данные дал
свой: своей свой своего своим своими своем свои своих свое
просмотр: просмотру просмотров
интерес: интересы интерес интересов интереса
инвестиционный: инвестиционных инвестиционной инвестиционный инвестиционному инвестиционного инвестиционным
тариф: тарифов
умный: умным
реквизит: реквизиты
слово: словом слово слову слова словам слов
расширить: расширить расширенными
краткий: кратчайшие краткое
арбитражер: арбитражеров арбитражер
позиция: позиция
посол: посол
соцсеть: соцсети соцсетях
претензия: претензию претензий
быть: будут буду будем суть
определять: определяла определяет определяют
мегапроект: мегапроектов
ждать: ждало ждите ждать
признавать: признавали признают признавать
вглубь: вглубь
финансовый: финансовым финансовыми финансовую финансового финансовых финансовая финансовой финансовому финансовые финансовый
корректно: корректно
формироваться: формируется
институт: институт институтах
придавать: придающих
продукт: продуктами продукте продукты продукт продуктов продукта
расход: расходов расходы
требовать: требует требуют требовали
норма: норм нормой норма
отлично: отлично
продукция: продукцию продукция продукции
мера: мере мерами меры
один: одна одной одно одну одним одному одних
изображение: изображением
скептически: скептически
предложение: предложения предложение предложении
проверка: проверки проверке проверка проверок
многовекторность: многовекторность
должный: должен должны должной должна должно
высказываться: высказывались
демографический: демографической
шестьдесят: шестьдесят
место: места место местах
продакт: продактов
поиск: поиска
корректный: корректное
уточнить: уточните
специальный: специальный специальных
наш: нашу наше нашим нашей
риск: рисками риск риски рисков риску
евразия: евразии
ковачича: ковачич
исправлять: исправлять
цель: целям целей цели
резкий: резкое
отказать: отказал
вариант: варианты вариантом вариантов варианта вариант
особенность: особенности
денежный: денежных денежного
беларусь: беларуси беларусь
немногий: немногих
радикально: радикально
способ: способы способов способ
крупный: крупнейших крупнейшего крупной крупная крупнейшими крупного крупных крупные
уточнять: уточняет
узнавать: узнавал
аналог: аналог аналогах аналогом
движение: движение
выдать: выдан выдать выдала
количество: количество количеству количества количестве
инфраструктура: инфраструктуру инфраструктура
использовать: использовать использована
карман: кармане
бухгалтерский: бухгалтерские бухгалтерском бухгалтерских бухгалтерской бухгалтерский бухгалтерская
окончательно: окончательно
метод: метод методов методы
санкция: санкции санкциям санкций санкциями
недавний: недавней
затруднить: затруднить
цена: цены цене цена
просчитать: просчитано
изложить: изложенного
мосбиржа: мосбиржа
электроника: электронику электроники электроника
превратить: превратить
синтез: синтез
криптовалюта: криптовалюта криптовалюту криптовалюте криптовалютой
итог: итогу итоге итогам итоги итог
верить: верит
соответствующий: соответствующих соответствующие
страна: стран стране страну странами страны странах страна
регулятор: регуляторы регуляторами
сфера: сфере сферу
приниматься: принимаются
печально: печально
римлянин: римляне
котировка: котировки котировок
своровать: своровать
рост: росту рост роста
потовой: потовые
название: названии название
сторона: сторона стороне стороны сторону
вы: вами
общий: общим общий общие общей общую общему общем
крепкий: крепкой
технология: технологиями технологии технологий технологиям технологиях
адрес: адрес
гонконг: гонконга гонконге
чувствовать: чувствовать чувствует
государство: государствами государств государство
мир: мир мире миру
инвестиция: инвестиции инвестиций инвестициях инвестициям
финансирование: финансирование
слишком: слишком
убедить: убеждены
нюанс: нюансы нюансов
нездоровый: нездоровый
кодировать: кодировали
предоставление: предоставление предоставлении
политика: политики политику
регулярный: регулярные регулярных регулярную
итальянский: итальянские
покупатель: покупателей покупателя покупатели
чип: чипов
правда: правдой правда
услышать: услышит услышать
участок: участках участке
приложить: приложит
стратегический: стратегическом
проявить: проявили проявил
пекин: пекину пекин пекина
происхождение: происхождения
фирма: фирм фирму фирмы фирмам фирма
третьесортный: третьесортных
касательно: касательно
договор: договоров договор договора договоры
созревание: созревания
тихо: тихо
вызвать: вызвали
идти: идут идет идущий
биткоин: биткоинов
состав: состав составе
проверять: проверять проверяют проверяю проверяет
школа: школа школы
каждый: каждая каждой каждый
полный: полную полной полный полным
обтекаемый: обтекаемые обтекаемых
оставить: оставили оставить
похоже: похоже
проходить: проходил прохожу
сибирь: сибири
товар: товаров товары
европа: европу европа европы европе
третий: третье третий третьим
давать: давайте давать дает дают
весь: всему всем всей вся весь всеми
человек: люди людям человек людей человека
периодически: периодически
нужно: нужно
первый: первую первая первые первых первой первого первый
правительство: правительство правительствами
крым: крымом крыма
оцифровать: оцифровать
номад: номадов
профессионал: профессионалов
кирилл: кирилл
работать: работают работает работать работающих работаю работающие работали работал
путин: путин путиным
номинал: номинала номиналу
палка: палки палках палку
кредит: кредитом кредитов кредит
банк: банки банк банков банке банку банками банком банках банка
обеспечивать: обеспечивает обеспечивают
приобретать: приобретают
готовый: готовы готовой готов
сотня: сотен сотни
отодвинуть: отодвинуты
осилить: осилит
простой: проще простейших
вашингтон: вашингтона
включая: включая
бывший: бывшие бывший
похитить: похитили
судебный: судебных
поставляться: поставляться поставляется
мужской: мужской мужским мужскую мужская мужские
потоотделение: потоотделению
классический: классические
машинка: машинками
важный: важнейшим важный важные важное важнее
разный: разными разные разной разных
закон: закона законов закону закон
шпионаж: шпионаж
совет: совета
надёжный: надежный надежных надежным
мысль: мысли мыслями
механизм: механизм
захват: захват
голова: головой голову
требование: требованию требования
железо: железо
физик: физиков
подешеветь: подешевевшие
негативный: негативных негативного негативная
категория: категориям
получить: получил получите получили получив полученных получить
вакансия: вакансии
включать: включающие
новый: новые новых новой новейших новом новая нового новый
получаться: получается получались
усвоить: усвоил
криптобиржа: криптобиржей криптобиржах
примерно: примерно
кератин: кератина
сервис: сервисы сервис сервисам
огласка: огласке
крипта: крипте крипты крипту
юрисдикция: юрисдикциях
долговой: долговые долговых
доход: доходов доход дохода доходы доходах
экосистема: экосистема экосистемами
копирование: копирования
безумный: безумном
дважды: дважды
увеличить: увеличит увеличила увеличить
поток: потоки
фиксировать: фиксирует
феодальный: феодальной
намерить: намерены
смочь: сможет смогли смогу сможем смогут
тысяча: тысячах тысяч тысячи
различие: различий различие различия
дело: деле дел делу дело дела
привязать: привязана привязанные
текст: тексте тексту
больший: большую большим большие большем больших большего большее большая
фактор: факторами факторов
учреждение: учреждения учреждений
базовый: базовых базовым
претендовать: претендовать
ставить: ставить
отметить: отметить
полноценный: полноценную полноценная
существо: существа
точнее: точнее
остаться: остались оставшиеся оставшихся останется остался останутся
поверить: поверить
начисляться: начисляется
полезный: полезной
развернуть: развернуть
бежать: бежать
изначально: изначально
сказать: сказали сказать сказал сказано скажу
злоупотребление: злоупотребления
преобладание: преобладания
реальность: реальность реальности
положение: положении положение
разобраться: разобраться разобравшись разберется
подписываться: подписывайтесь
товарооборот: товарооборот
система: системе система системы
отпускной: отпускным
верифицировать: верифицированных
программа: программа программы программе программ программу
пуш: пуш
турецкий: турецкий
рекордный: рекордной
ценный: ценными ценных ценно
российский: российскую российских российский российского российским российское российской российскими российские российская
пара: пара пару пары
таковой: таковой
осуществлять: осуществлять
личный: личным личный
гигант: гигантов гигант
дата: дату
позволять: позволяющий позволяла позволяет
никакой: никакой никакого никакие никаких никакая
гемоглобин: гемоглобина
посыл: посыла посыл
постоянный: постоянная постоянного
вновь: вновь
помогать: помогает помогают
переводить: перевожу переводит переводят переводить
порядок: порядке порядок
эквадор: эквадора
иметься: имеются имеющихся имеющегося
субъект: субъектами
делать: делают делать делали делает делайте делая
насколько: насколько
фиатный: фиатные фиатную
читатель: читатели
поручить: поручили
причём: причем
атака: атак
публично: публично
уверенно: уверенно
бот: боты
дефолт: дефолта дефолт
ой: ой
партнёр: партнером партнер партнеры партнерами
коиновый: коинов
причина: причина причин причиной причины
весна: весна
лежать: лежащим лежат лежит
второй: второму второй
перевернуть: перевернули
электронный: электронными
подходить: подходит подходят подходить
знать: знает знаю знаем знали
принять: приняли принятое принято принять
показывать: показывает показывало
мы: нам
убыток: убытки
попутно: попутно
необратимый: необратимый
понимать: понимает понимаю понимают понимать понимали
раб: раба
родиться: род
прочтение: прочтения
ответить: отвечу ответили ответят ответить
креативный: креативно
продажа: продаж продажи
двусторонний: двусторонний двусторонней
даркнуть: даркнет
эпидермис: эпидермиса эпидермис
закрывать: закрывать
решение: решении решение решениями решений решения
будущее: будущем
дощечка: дощечки дощечках
вести: вести ведет
быстрый: быструю быстрее быстрый
равняться: равнялось
путать: путать
получиться: получится получилось
приносить: приносить приносит
точность: точность
срок: срока сроки срок сроком
пекарный: пекарен
бухгалтер: бухгалтера бухгалтеры бухгалтеров
честно: честно
треть: трети треть
май: мае
терроризм: терроризма
думать: думаю думать думает
криптоэнтузиаст: криптоэнтузиастов
пк: пк
выводить: выводила
совершать: совершать совершал
печальный: печальная
александр: александр
коучинга: коучинг
чувствительность: чувствительностью
якорь: якорю
похожий: похожий
звонить: звоню звонят звонила
покрыть: покрытых покрыть
оплата: оплата оплаты
цифровой: цифровые цифровых
жизнь: жизни жизнь
израсходовать: израсходован
понятно: понятно
считать: считали считают считаю считает считать
армия: армиями армией
последствие: последствия
женщина: женщин женщины женщиной
мнение: мнению мнения
содержание: содержание
газопровод: газопровода газопроводов
отказываться: отказываюсь отказывались
год: году годами годам года годы годом год лет
рандомный: рандомная
идеология: идеология
безотзывный: безотзывные
объём: объем объему объемов
кайфовать: кайфовать
ты: тебе
скрипт: скрипту
определяться: определяться
деньга: деньги деньгах денег деньгами
произойти: произойти
существенный: существенную существенных
определить: определить
связаться: связался связаться свяжутся свяжется
статистика: статистику
никита: никита
достаточно: достаточно
внешность: внешность
клювик: клювике
тяжело: тяжело
россия: россии россией россию россия
сверяться: сверяться
соответственно: соответственно
переговоры: переговоров
отдать: отдать отдаст
интенсивно: интенсивно
беседа: беседы
разместить: разместить размещены размещено
обслуживать: обслуживать
заместить: заместить
герман: герман
поддержка: поддержка поддержки поддержке
культура: культуру
действовать: действовать действует
обрабатывать: обрабатывал обрабатывала
ограничение: ограничений ограничениям ограничениях ограничение ограничения
сми: сми
рублёвый: рублевыми
хронологический: хронологической
доверять: доверял доверять
отвечать: отвечали отвечает отвечая отвечают
инопланетный: инопланетные
возглавлять: возглавляемым
биржа: биржи бирже
стать: стать стало стали станет став стал статей
шкала: шкала
приличный: приличных приличные
европейский: европейские европейских европейский европейскими
сюда: сюда
ощутить: ощутили ощутить
путём: путем
сильно: сильно
опережать: опережающего
транзакция: транзакций
полагать: полагает
декларировать: декларируют декларируемое
мой: моему мою моих моей моего мои
финансист: финансистов
маленький: маленькую меньше маленькие
фз: фз
маловероятный: маловероятно
выплата: выплаты выплате
другой: другое других другими другие другого другому другим другая
приходить: приходят приходит
активный: активная
желание: желании
непонятно: непонятно
тыс: тыс
который: которые который которых которыми котором которой которого которое которая которым которую
пройти: прошла прошли прошло прошел
абсолютно: абсолютно
вырезка: вырезка
заголовок: заголовка заголовок заголовки
импортировать: импортируемые импортировала
явно: явно
стандарт: стандарты
снять: сняли сняты
минцифра: минцифры
возможность: возможностях возможность возможностей возможности
пытаться: пытается пытаться пытаюсь пытался
заботиться: заботиться
диктовать: диктовать
волшебный: волшебная
ихтиандра: ихтиандр
потенциал: потенциале потенциал
выражение: выражением
большой: большое большого большой велики большому
успех: успехов успехом
термин: терминах
писатель: писатель
объявить: объявив объявила объявил
аудит: аудита аудиту аудитами
заводить: заводят
напечатать: напечатанных
изменение: изменений изменением изменения
сила: силу сила
независимый: независимых независимые независимого
сессия: сессию
гектар: гектар
запросить: запросили
многий: многих многими
дипломатический: дипломатическое
стабилизироваться: стабилизируется
суть: сути
международный: международных международной
советский: советские
панамский: панамском
агрегатор: агрегатор
пустой: пустая
бразилия: бразилии бразилию
структура: структура
приводить: приводящих приводят
указывать: указывали указывает
сбыт: сбыта
мутный: мутным мутном
переставать: перестает
управление: управления управление
донасытить: донасытить
статья: статью статьи статьей статье статья
менталитет: менталитет менталитетом
депозит: депозиты депозите депозит депозитах
решать: решать решают решает
женский: женским женской
вероятный: вероятнее
стейблкоина: стейблкоин стейблкоины стейблкоина
снабжать: снабжают
приложение: приложения приложении
попытка: попытки попытке попыток
пивоваренный: пивоваренные
время: времени времена время времен
соединить: соединенные
обитание: обитания
распределяться: распределяются
предлагать: предлагает предлагают
превращаться: превращаться превращались
писать: пишут писать пишет писал пишем
обращение: обращении обращению обращений обращениям обращения обращение
капитал: капитала капитал
удаваться: удается
долгожданный: долгожданные
кремль: кремль
берег: берегов
смертельный: смертельная
корея: корея кореи
империя: империя
древний: древнем древний древней
помарка: помарки
карьера: карьеры
санкцийсобирать: санкцийсобираем
настоящий: настоящих настоящего настоящие настоящим настоящий настоящее
табличка: табличек таблички
право: праве прав право
кстати: кстати
банковский: банковской банковских банковскими
алгоритм: алгоритма алгоритм
зависеть: зависит
жаль: жаль
нанимать: нанимать
дурак: дурак
криптомир: криптомире
план: планах план плане
отображаться: отображаются
приоритет: приоритет приоритетов приоритетом
ведение: ведение ведения
комлевый: комлев
союз: союз союзом
чэнь: чэнь
жёсткий: жесткую жесткий
шемет: шеметов
актив: активах активы активов активами актив
отбросить: отбросило
продать: проданных продать продадут
платёж: платежи платежей платежами платежа
государственный: государственной государственные государственных
разрядиться: разрядился
строиться: строится
китаевед: китаеведа
выдавать: выдают
говорить: говорит говорят
экономический: экономической экономическая экономическим экономическом экономическими
возникать: возникает возникающих
смотреть: смотрим смотрю смотрит смотря см
течение: течение
политический: политического политические политическое политической политических политическом
сценарий: сценарий сценария
опасение: опасения
обслуживание: обслуживания
хотеть: хотят хотите хотели хотело хочу хотел хочет
магазин: магазин
снятие: снятии снятие
заря: заре
население: населении населения
заверить: заверил
боль: боль болью
зритель: зрителю
строить: строить
донбасс: донбассом
лишать: лишает
призвание: призвание призванием
информация: информацию информации информация информацией
час: часов часа
документально: документально
выгодный: выгоднее выгодным
воздерживаться: воздерживалась
кожа: коже кожу кожи кожа
принимать: принимающим принимающие принимает принимать
воспитанный: воспитан
авиационный: авиационных
условие: условие условиях условия условии
приз: призом
сырьё: сырья сырье
рассчитать: рассчитать
удача: удачи
активность: активность активности
эксперт: эксперты эксперт экспертами
составить: составленные составив составил
какой: каких какие какое каким
месяц: месяцы месяца месяц месяцев
хакерский: хакерских
снова: снова
тёмный: темным
воск: воском
мошенник: мошенники
дорога: дорогу дорога
межбанковский: межбанковских
превысить: превысит
знание: знаний
зачастую: зачастую
углубление: углублений
фраза: фразой
жирность: жирность
пометка: пометкой
десяток: десятков
аппарат: аппараты
алла: алла
чувство: чувства чувств
предпринять: предпринять
понятный: понятными
воодушевлять: воодушевлять
написать: написать написали
столь: столь
рн: рн
класть: кладет класть
аж: аж
случай: случай случае
сожаление: сожалению
отнести: отнести
успешно: успешно
разбирательство: разбирательство разбирательств
встреча: встреч встрече
запрашивать: запрашивает запрашивали запрашивать
отличаться: отличается
наличный: наличных
абьюзер: абьюзер
сокращаться: сокращается
сюрприз: сюрпризы
добиться: добились добиться
индивидуальный: индивидуального индивидуальной
хирург: хирург
необходимо: необходимо
купить: купят купить купили купил купленный купленную
содержаться: содержащейся
осознавать: осознают осознающий
уведомление: уведомления уведомлений
действительно: действительно
питерский: питерский
ставка: ставки ставку
поступать: поступало
долго: долго
понадобиться: понадобились
деталь: деталями деталей
дерматит: дерматит
решаться: решались
состояние: состоянию состояние
число: числе числом
трудность: трудностях
особо: особо
авить: авито
противоракетный: противоракетной
установленный: установленных
действительный: действительна
оказаться: оказаться оказалась оказались оказался оказалось
начало: начала начало
небольшой: небольшим небольшом небольшой
предотвратить: предотвратить
описать: описала описанных
близкий: ближайшие близкими ближайшее
письменный: письменных
процент: процентов проценты
неоднозначность: неоднозначность
экспортный: экспортного
занимать: занимает
побыть: побыть
рассказывать: рассказывать рассказываем
сильный: сильный сильной
подзаморозить: подзаморозить
монотонный: монотонной
оценка: оценками оценка
полый: полых
мочь: могут мог могла могло могу могли можете можем
помочь: поможет помогли помочь
обогатиться: обогатиться
стриминговый: стриминговый
сам: сами самим самом самого само самой
резко: резко
возврат: возврата
потрясти: потрясти
аналитика: аналитика
использование: использованием использование
хачатряна: хачатрян
подстёгивать: подстегивает
протяжение: протяжении
меланин: меланина
нога: ног
лицо: лицу лицам лица лицами
представить: представленная представленных представить
выше: выше
отель: отелей
свыше: свыше
поражать: поражала
иван: иван
нелинейный: нелинейная
экспансия: экспансии
собственно: собственно
провозгласить: провозгласили провозгласить провозгласил
подписка: подписки подписку
соображение: соображения
серьёзно: серьезно
менеджер: менеджеры
профиль: профиле профиля
военный: военными военных военное военные военной
саппорт: саппорт саппорта
несколько: несколькими нескольких несколько
подушка: подушкой
психология: психологию
основной: основной основные
основа: основы основе
основать: основал
производитель: производители
контракт: контрактов контракты контракт
пассив: пассивов
счёт: счет счета счету счете счетами
контур: контура контур
переживать: переживайте переживает
доллар: доллару доллары долларов доллар долларом
момент: моменту моментов момент моменте момента
спешно: спешно
подозрение: подозрения
прокуратура: прокуратура прокуратуры прокуратурой
спасть: спал
соперничество: соперничества
показать: показать
сходить: сходить сходи
манкевич: манкевич
ошибка: ошибку ошибкой ошибки ошибка ошибок
заморозить: замороженными заморожены заморозят заморозить заморожен
последний: последним последнее последние последнюю
рада: рады
поделиться: поделиться поделился
оплатить: оплатите
довериться: доверился
зарабатывать: зарабатывать
всеобщий: всеобще
выбрать: выбрал выбрали
пора: порами пор пора
недвижимость: недвижимости
вид: виде
проблема: проблему проблема проблемы проблем
внешнеторговый: внешнеторговых
глина: глине
разрушить: разрушена
токен: токены токен токенов токена
уметь: уметь умеют
среднее: среднем
предлог: предлогом
эволюционировать: эволюционировали
помимо: помимо
китаец: китайцев китайцам китайцы
создание: созданию
потерять: потерявших потеряет потерять потеряла
материал: материала материалов
нигде: нигде
столбец: столбцам
кость: кость кости
компания: компания компанией компании компаний компаниям компаниями
оператор: оператор операторам
наличные: наличными
встретить: встретили
соблюдение: соблюдения
данные: данным данных
банкротство: банкротства банкротству
повысить: повысили повысить
главный: главная главным главном главный
оперативно: оперативно
миллиард: миллиардам миллиард миллиарда миллиардов
сериал: сериалов
следующий: следующей следующая следующее следующий
насаживать: насаживали
отношение: отношений отношения отношении отношениям
целое: целом
возмущение: возмущение
греция: греции
владимир: владимир
кондитерский: кондитерских
направление: направлениям направлений направление
компонент: компонентов
размер: размером размер размеру
кран: кран
допустимый: допустимому допустимый
находиться: находящимися находится находятся
награда: награду
молчать: молчу
решить: решен решить решил решена
самодостаточность: самодостаточность
друг: друг друзьями другу друга другом
слой: слой
щека: щек
допускать: допускал
владеть: владеющим владеют
вчера: вчера
чат: чат чате
записулька: записульках
собственный: собственный собственными собственные собственную
лес: лесов
торговый: торговым торговые торговыми
примитивный: примитивный
контекст: контекст
возможно: возможно
соответствовать: соответствует соответствующий соответствующим
проект: проектах проектами проекта
разочарование: разочарование
событие: событий событие событиями события
заболевание: заболеваний заболевание
повториться: повторились
взгляд: взглядами взгляд взгляды
старший: старшего старшая
самый: самыми самый самые самое самых самая самым
папирус: папирусе папирусах
обратить: обратить
н: н
столкнуться: столкнется столкнулись столкнувшийся столкнулся столкнулась
вкладчик: вкладчикам
трансграничный: трансграничных
нереальный: нереален
частное: частного
глава: глава
попробовать: попробовал
потратить: потратит
заключительный: заключительное
исправить: исправит исправить
перечислять: перечисляли
оружие: оружием оружия
персональный: персональный
уголок: уголках уголков
концепция: концепции концепций
такой: такими таким такие такая таких такое
ущерб: ущерб
рубль: рублей рубли рублях рублем
послать: пошли
впадать: впадает
установить: установить установлены установлен установили
понять: понять
поставка: поставки поставок
коробка: коробке
простить: простите
головной: головной
колдунство: колдунство
китайский: китайский китайская китайской китайским китайскими китайское китайском китайскому китайские китайских
тот: та те тому ту тех
вмешательство: вмешательству
контора: контор
заявить: заявили
нынешний: нынешние нынешнее нынешнему нынешних нынешнего
сверхнадёжный: сверхнадежных сверхнадежный
технологический: технологической технологического технологическую технологические
глиняный: глиняных глиняными глиняные
нести: несет нести
иной: иных иного иное
они: ими ними
вложить: вложенных вложить вложено вложены
собраться: собрались собрался собраться
услуга: услуг услугами
серия: серии
западный: западной западном западными западных западные
знакомый: знакомого знакомых знакомый
толща: толще
раскрывать: раскрываемый раскрывать
неизвестный: неизвестными
железный: железная
садиться: садимся
крах: краха крах
участник: участникам участников
выглядеть: выглядеть выглядящий
сша: сша
сообщение: сообщение сообщений сообщения
торговать: торговал торгуют
грек: греки
интересно: интересно
жирный: жирная
служба: служба службе службу службы
германия: германии германия германию
сотрудничество: сотрудничества сотрудничестве сотрудничеству сотрудничество
дырявый: дырявой
гордо: гордо
посмотреть: посмотрите посмотреть посмотрим
принцип: принцип принципах принципе
корпоративный: корпоративных
следствие: следствием
геоэкономика: геоэкономики
конкретный: конкретную конкретный
пусть: пусть
выпускать: выпускает
ёж: еже
девальвация: девальвация
заниматься: занимающейся занимались заниматься
пробивать: пробивали
взяться: взялся
козырь: козырей
предугадать: предугадать
относиться: относились относилась относятся
вывод: выводу вывод выводы
специализировать: специализированные
отмывание: отмывании отмывание отмывания
дом: дома
народ: народы
внимание: внимание
широкий: широких шире
вправе: вправе
надежда: надежде надежды
два: двум двумя двух две
подход: подходы подхода
немало: немало
орган: органами
клиент: клиента клиентами клиентов клиентам клиент клиенты клиентом
начать: начать начали
оставаться: оставались остаются остается оставалась
видеть: вижу видел
неизбежный: неизбежным неизбежен неизбежное
комментарий: комментарий комментарии комментария комментариев
фильм: фильмов фильма
ловко: ловко
фигня: фигня
аккаунт: аккаунт
ежегодный: ежегодный
ум: ум
сбережение: сбережения
официальный: официальное официальных официальной официальная
объяснить: объяснить
лидер: лидер лидерам лидеров
надёжность: надежности надежность
цзиньпин: цзиньпин
ядохимикат: ядохимикатов
проекция: проекция
период: период периодом
иностранный: иностранных иностранные
озвучивать: озвучивать
телефон: телефонов телефон
критичный: критична
предполагать: предполагает
обед: обеда
компенсация: компенсацию компенсация компенсации
письменно: письменно
промышленность: промышленности
табак: табак
шесть: шесть
осознание: осознание осознания
атлантический: атлантического
оформлять: оформляя оформлявших
главное: главное
приостановить: приостановлены
вместе: вместе
макроуровень: макроуровне
это: это этим
проваливать: проваливай
тема: темы
завершение: завершения
тапка: тапки
строгий: строгий
э: э
себя: собой
работа: работа работу работы
кошелёк: кошелькам
принадлежать: принадлежит
популярный: популярного популярный популярных
аудитор: аудиторов
гормон: гормоном гормоны гормонов
нефть: нефть
прям: прям
фантазия: фантазии
убедиться: убедиться
вообще: вообще
перекос: перекоса
подмножество: подмножества
будущий: будущие
множество: множества
бумажный: бумажных
рогов: роговой
правоохранительный: правоохранительными
полечить: полечи
публичный: публичной публичная
минимум: минимум
свет: света
узнать: узнав узнали узнать
запрет: запрет
непонятный: непонятные
проявляться: проявляться
распоряжаться: распоряжаться
пароль: пароль
рубен: рубен
сократить: сократило сократить
расчёт: расчет
планировать: планировал планирует
драгоценный: драгоценные
баланс: балансом балансе баланса
посвятить: посвящены посвящена
таблица: таблица таблиц таблицы таблицами таблицу
урожай: урожаи
свежеть: свежей
доп: доп
добавить: добавленной
осознанный: осознанное
оон: оон
научиться: научился
старый: старейшего
книга: книгах книги
пилюля: пилюля
железа: желез железы
индустриальный: индустриальный
войти: вошла
центробанк: центробанка центробанк
арестовать: арестовали
расценить: расценили
обсуждать: обсуждали обсуждал
гость: гости
продолжать: продолжали продолжают продолжала продолжает
интеграция: интеграции
виноватый: виноватый виноват
демократия: демократии
линия: линиями линию линии
икс: иксы
энергоресурсы: энергоресурсов
вокруг: вокруг
американский: американской американским американский американскую американских
раздражающий: раздражающей
онлайн: онлайн
изображать: изображали
неприятный: неприятных неприятные неприятным
ограниченный: ограниченного
техника: техники
информационный: информационных информационный
запоминать: запоминали
потаскаться: потаскаться
цитата: цитату
наиболее: наиболее
действие: действиям действий действия действию
благодаря: благодаря
полнота: полноты
сторонник: сторонники сторонник
зависимый: зависимом
идея: идее
напрягаться: напрягается
минимально: минимально
объяснение: объяснения
минеральный: минеральные
манера: манерой
встречаться: встречается
ложь: лжи
потеря: потерь потери потере
предел: пределы
почикать: почикали
скупать: скупать
организм: организмом
доступ: доступ
бланк: бланк
восемьдесят: восемьдесят
сортировать: сортировало
растительный: растительного
поворот: поворот
джанкарло: джанкарло
указать: указала
бесплатный: бесплатна
раскалывать: раскалывали
виктория: виктория
счастливый: счастливым
перестроить: перестроили
граница: границ границы границу
дальний: дальний дальнего
многое: многое многому
приемлемый: приемлемым
отверстие: отверстий
сохраняться: сохраняются
труд: труда
перечисление: перечислением
чинаровый: чинарова
ваш: вашими вашего вашему ваша вашей
автомобиль: автомобилей
сбер: сбером сбере
пользоваться: пользовались пользуются пользуюсь пользовался пользовалось пользоваться
мужчина: мужчиной мужчин мужчины
подделать: подделать
фишка: фишек
вещь: вещь
липски: липски
напиток: напитки
евразийский: евразийским евразийском
резина: резина
процесс: процессы процессов процессом процессе процесс
гораздо: гораздо
хотеться: хочется хотелось
горячий: горячую
часть: часть части
устойчивый: устойчивы устойчивый устойчивого
джош: джош
опережение: опережением
закупать: закупает
укрупняться: укрупняться
белый: белую
беспокойство: беспокойство
заменить: заменил
задача: задачи задачу
обязательство: обязательствам обязательств обязательства
вдобавок: вдобавок
благо: благо
входить: входит
воспитание: воспитание
известный: известных известной известными
реализация: реализации
стараться: стараются
разобрать: разберем
почему: почему
избежать: избежать
экспорт: экспорта экспорт
проанализировать: проанализировать
поисследовать: поисследовать
корректность: корректность
погасить: погасить
отрасль: отрасли
сыск: сыска
единственный: единственной единственный единственная
высокий: высоких высоким высокой
рюмин: рюмин
пересмотреть: пересмотрел
плохо: плохо
прошедший: прошедшей
выход: выходе
сколково: сколково
нравиться: нравится
ликвидировать: ликвидировать
занизить: заниженной
продвинуть: продвинутые продвинутой
поставщик: поставщиков поставщиком
бесконечный: бесконечную
начинать: начинают начинаете начинает
зарплата: зарплат зарплаты зарплату
апатия: апатия
вода: водах
закрытый: закрыта
стоимость: стоимость стоимостью стоимости
огромный: огромными
балл: баллом балл баллу
некоторый: некоторых некоторые некоторыми
засечка: засечки засечек
установка: установок
июнь: июне
пользователь: пользователей пользователь
напоминать: напоминает
регистрироваться: регистрируются
открыть: открыта
спойлер: спойлер
сообщать: сообщают сообщает сообщать
фин: фин
переосмысление: переосмысление
бухучёт: бухучета
справка: справку
привести: привело привели привела
моментально: моментально
репутация: репутации репутация
нужный: нужном нужны
краткосрочный: краткосрочных
упоминать: упоминает упоминаемые
современный: современный современном
звр: звр
коммуникация: коммуникации коммуникациях
топ: топе топ
удовольствие: удовольствия удовольствию удовольствие
тонкий: тонким
жаба: жаба
чужой: чужие
несмотря: несмотря
перевести: перевел перевести
средневековье: средневековье
копировать: копировать
финансы: финансам финансах
надеяться: надеюсь надеяться
недоговаривать: недоговариваешь
зависнуть: зависла
температура: температуры
отдельный: отдельную отдельные отдельный отдельных
энергетический: энергетические энергетическая
территориальный: территориальных
особенно: особенно
перековываться: перековываются
токсичный: токсичных
личностный: личностный
впервые: впервые
оттолкнуться: оттолкнуться
ежеквартальный: ежеквартальные
задуматься: задуматься
расти: растущий растет расти
урука: урука
нарушать: нарушать
дебетовый: дебетовый
осторожный: осторожного
учитывать: учитывать учитывали учитывая
сухой: сухая
минимальный: минимальных минимальной
идиот: идиоты
бумажка: бумажке
реальный: реальная
день: дни дня день дней
юридически: юридически
портфель: портфеля портфель
прозрачный: прозрачный
неограниченный: неограниченных
функционировать: функционирует
соотношение: соотношении
контролировать: контролирует
сутки: суток
наказывать: наказывать
этот: этих этому эта
гарантировать: гарантируют гарантировал
заключение: заключением заключение заключении
скреплять: скрепляли
что: чему
остальной: остальных остальное
коллагеновый: коллагеновых
перепись: переписи
терминал: терминал
древность: древности
схема: схемы
появляться: появлялись появляется
заём: займы
отмечать: отмечает отмечают
сложиться: сложившемся
выяснить: выяснили
сотрудник: сотрудника сотрудники сотрудник
пять: пятью пять
хватить: хватит
забрать: забрать заберут
карточка: карточки карточек
прогореть: прогорите
ровно: ровно
смартфон: смартфонов
эффективный: эффективнее
развитие: развития развитием
правитель: правители
выстроиться: выстроилась
буклемишев: буклемишев
передать: передали
упрощение: упрощения
обострение: обострение
торговля: торговля торговли
асимметричный: асимметричным
статус: статуса
рекомендовать: рекомендую
приёмный: приемной
отзыв: отзывы
знаковый: знаковом
прохождение: прохождения
взаимоотношение: взаимоотношения
слышать: слышал слышишь
кейс: кейс кейсов
замена: замены
холлерит: холлерит
венера: венеры
поймать: пойман
желать: желающих
совпадать: совпадали
различный: различными
толкать: толкать
затрагиваться: затрагиваются
необходимость: необходимость
делить: делить деленная
москва: москву москва москвы москве
трейдер: трейдеров
сочувствовать: сочувствует
задаваться: задаваться
появиться: появилась появился появились
доска: досками
выгода: выгоды
напрямую: напрямую
одолжить: одолженные
подготовка: подготовке
рассчитывать: рассчитывали
достать: достать
денежка: денежку
серьёзный: серьезные серьезной серьезный
распродать: распроданы
предстоять: предстоит
суверенитет: суверенитет
перепробовать: перепробовать
мобильный: мобильным мобильных мобильный
себорейный: себорейный
диапазон: диапазоне
держатель: держателем держатели
инфляция: инфляция
прошлое: прошлого
сальный: сальных
результат: результате результаты результатами результат
вечный: вечны
буквально: буквально
громоздкий: громоздкими
точно: точно
центр: центра
объявление: объявления
сто: сто ста
целлофановый: целлофановую
недоступный: недоступен
связываться: связываюсь связывайтесь
внести: внес внести
обстоятельство: обстоятельствах
обеспечить: обеспечен обеспечить
говориться: говорится
рад: рад
полгода: полгода
гипотетический: гипотетический
каменный: каменными
повод: поводу поводов
глубоко: глубоко
привязка: привязка привязки
публиковать: публикуют публиковать
семья: семье семьей
кво: кво
запад: западом запада
бухгалтерия: бухгалтерии
бумага: бумаги бумаг бумаге бумагами
осуществляться: осуществлялись
призывать: призывают
карта: карт карта карты карту
провести: проведена
окончательный: окончательном окончательным
окончание: окончания
предприимчивый: предприимчивым
воспользоваться: воспользоваться воспользовались
энергетика: энергетику
прислать: пришли прислали
ближневосточный: ближневосточных
блокировка: блокировками блокировкой блокировку блокировка
чей: чьей
поле: поле полей
осмотрительность: осмотрительности осмотрительность
запустить: запущенная запустить
дойти: дойти дошли
вдоль: вдоль
лид: лидов
начинаться: начинается
рассмотреть: рассмотрим
построить: построенному
сумма: сумму суммой сумма суммы
психолог: психологу
безвыходный: безвыходном
пропагандист: пропагандисты
участие: участием участия
вклад: вклады вкладами вклад вкладе
ярослав: ярослав
происходить: происходить происходит
подождать: подождать
хранить: хранили хранить
возраст: возрастом возрасте
финляндия: финляндию
выпустить: выпущенный выпустили выпустившего
фактически: фактически
пластический: пластический
импортироваться: импортировались
среди: среди
бангладеш: бангладеша
камешек: камешки
удивить: удивлена удивлены
продолжиться: продолжилась
общаться: общаться
ресурс: ресурсы ресурсов ресурсами
проводить: проводили
десятка: десяток десятки десятку
китай: китае китая китаем китаю китай
талант: талантов
выбор: выбором выбора
проходимец: проходимцами
сладкий: сладкой
дозвониться: дозвониться
коммент: комменты комментов
максимович: максимыч
стабильный: стабильного
тысячелетие: тысячелетие тысячелетия
накопительный: накопительный
смысл: смысл смысла
компьютер: компьютеров компьютер компьютерам
монополист: монополист
клиентка: клиентке
назвать: назвать
переход: переход
успеть: успел успели успело
сон: сны
ломануль: ломанули
подобный: подобными подобного подобных подобное подобной подобные
ведущий: ведущих
связь: связей связи связь
прийтись: придется пришлось
древесина: древесина
си: си
жёстко: жестко
прибор: прибор
заявление: заявлении заявление
обеспокоенность: обеспокоенность
хрустеть: хрустящим хрустящий
погашение: погашения погашение погашению
пропустить: пропустить
источник: источник источников
сменить: сменили
выполняться: выполняться
сложнопредсказовать: сложнопредсказуемым
процитировать: процитирую
против: против
создавать: создают создавая
хиленький: хиленькое
цифра: цифра
видно: видно
унилатерализм: унилатерализм
вьетнам: вьетнама
отправить: отправил
взаимодополняющий: взаимодополняющими
костяной: костяными
уильям: уильям
извинение: извинения
путешествовать: путешествовал
многие: многие
павел: павел
суммировать: суммирующую
наработка: наработки
обязательно: обязательно
опираться: опирались
доходность: доходность
страдать: страдают страдает
зуб: зубов
голосование: голосованиях
достигать: достигает
ответ: ответы ответа ответ
очень: очень
основное: основном
приоритезировать: приоритезируем
палец: пальцах
гиперболизация: гиперболизация
облигация: облигациях облигаций облигации
практически: практически
уволить: увольте
рекомендация: рекомендаций рекомендацией
октябрь: октябре
жаловаться: жаловаться
море: моря
оценить: оценить
перемещение: перемещения
обучать: обучало
упавший: упавшей
подбородок: подбородка
поздний: позже
старинка: старинке
продлять: продлять
стейблкоин: стейблкоинов
гегемония: гегемонии
немного: немного
одежда: одежды
критиковать: критиковать
уклонение: уклонения
полностью: полностью
компромисс: компромисс
вынудить: вынудили вынуждены
плюс: плюс
положить: положить
центральный: центральной
ура: ура
значит: значит
телеграмма: телеграмм
предупреждение: предупреждений
человечество: человечество
рецидив: рецидивы
татьяна: татьяна
вычисление: вычислениях вычислений
профессиональный: профессиональных профессиональный
оговорка: оговоркой
поделать: поделать
конкурент: конкурента
председатель: председатель
читать: читать читал читали
падать: падает
принятие: принятия
осуждение: осуждения
замаскированный: замаскированных
отрывок: отрывки
подумать: подумай подумать подумал
издевательский: издевательский
интресный: интресный
ошибочный: ошибочные
достоверность: достоверности
изменить: изменил изменить изменила
признаваться: признаваться
зрение: зрения
прийти: пришел пришла прийти
консолидированный: консолидированные
свод: сводов
бизнес: бизнеса бизнес
свободный: свободные
динамика: динамика
содержать: содержит
неминуемый: неминуем
доверить: доверить
академический: академическому
однако: однако
понимание: пониманием
инвестор: инвестором инвестора инвесторы
влияние: влияние влияния
спрос: спрос спроса
любой: любая любом любому любые любой
повыситься: повысился
бешенной: бешенной
наверное: наверное
остро: остро
корпорация: корпорациями
максимально: максимально
металл: металлы
перевешивать: перевешивают
ранний: раньше
посредник: посредников
вкладывать: вкладывает
ситуация: ситуация ситуации ситуацией ситуацию
дыра: дырой
составлять: составляло составляет составляют составлять
истребование: истребования
арбитраж: арбитража
вероятно: вероятно
инвесткопилка: инвесткопилки инвесткопилка
выпуск: выпуске выпуск
машинотехнический: машинотехническая
ломиться: ломятся
тенденция: тенденция
фабрика: фабрик
ключевой: ключевых ключевой
неразрывно: неразрывно
налом: налом
вексель: векселях векселей
реконструкция: реконструкция
министр: министр министров
вроде: вроде
разумный: разумные
заставить: заставило
исходящий: исходящих
рядовой: рядовая рядовой
включительно: включительно
вина: вину
кровоснабжаться: кровоснабжается
повышенный: повышенной повышенное повышенному
нефтегазовый: нефтегазовая нефтегазовой
значительно: значительно
рф: рф
далёкий: дальше
зарубка: зарубками
выстраивать: выстраивал
подкрепить: подкреплен
управлять: управляют управляющие
воздержаться: воздержался
плохой: плохой плохим
срочно: срочно
договориться: договорились
сигнал: сигналом сигнал
использоваться: используются
рубеж: рубежом
вторичный: вторичных
сложный: сложнее сложные
картинка: картинку
отмыться: отмоешься
переходить: переходить
левый: левых
однотипный: однотипных
пообещать: пообещали
поездка: поездки
интегрировать: интегрированная
рулить: рулят
снятой: снятые
правило: правило правила
отмечаться: отмечается
директор: директор директором директора
максим: максим
национальный: национальных национальной
сельский: сельское
коснуться: коснулось
алексей: алексей
южный: южной
дипломатия: дипломатии
живой: живым
элита: элиты элита
заблокировать: заблокирована заблокированы
япония: японию японией
расцвет: расцвет
партнёрство: партнерства
своеобразный: своеобразным своеобразные
способность: способностью способность
раскрываться: раскрывается
пахать: пашем
портиться: портиться
организация: организация организации
оказываться: оказывается
известно: известно
вызов: вызовах
подделка: подделку подделкой
дырка: дырки
вложение: вложений
усилие: усилия
стиль: стиле
кусок: куски
призма: призмой
являться: являлось является являемся являться являлся
деятельность: деятельность
смещение: смещения
контакт: контакты
альтернатива: альтернатива альтернатив
складской: складской
увеличиться: увеличившись увеличился
отсюда: отсюда
вернуть: вернуть
предыдущий: предыдущих предыдущим
власть: власти
колебание: колебаний
существующий: существующее
украина: украину украины
сегодня: сегодня
отправлять: отправляет отправлять
познавательный: познавательного
яма: яму
семь: семь
неприятно: неприятно
чета: чета
потребление: потребление потребления
изобретатель: изобретатель
аудиторский: аудиторским
половина: половине половина
распространиться: распространился
отказаться: отказаться
существовать: существовать существует существовало
часто: часто
получать: получаю получать
речь: речь
одинаковый: одинаковой
обещать: обещали обещают обещает
возникнуть: возникли
трата: трат
продолжаться: продолжаться
стоковый: стоков
заподозрить: заподозрила
скажем: скажем
обязать: обязали обязаны
оборот: оборот оборота
отрубиться: отрубиться
чаевой: чаевые
высокоскоростной: высокоскоростная
общественный: общественного
хотя: хотя
предприниматель: предпринимателями
защита: защиты
потенциальный: потенциального потенциальных потенциальные
бакс: баксов
хороший: хорошие лучшем лучших
расплатиться: расплатиться
темп: темпами
большинство: большинстве
покупка: покупка покупки покупок
плач: плачу
луч: луч
присоединиться: присоединиться
пояс: пояс
последовательность: последовательности
условный: условный
машина: машина машинах машины машину
создатель: создатели
переписываться: переписываться
слушать: слушай слушает
демаркация: демаркации
документ: документы документов
нечего: нечего
разговаривать: разговаривает
покупать: покупая
массово: массово
имущество: имущества имущество
краснота: краснота
автоматизация: автоматизация
россграм: россграма
склонность: склонность
очередной: очередная очередной
воронов: воронов
бренд: брендов бренд
называться: называется
касса: кассой кассе
доля: долю
владелец: владельцы владельцам
грэй: грэй
составление: составлению
никак: никак
сложно: сложно
изменяться: изменяющийся
новостной: новостной
лимит: лимиты лимита лимит
предусмотреть: предусмотрена
пойти: пойти
пункт: пунктам пункт пунктами
торговаться: торгуются торгуется
поразбираться: поразбираться
например: например
охват: охватов
разногласие: разногласия
экспертиза: экспертиза
строительство: строительства строительство
миронов: миронова
глобальный: глобальной глобального
частичный: частичный
людская: людской
софт: софта
выразить: выражена
семя: семена
просыпаться: просыпаюсь
перфокарта: перфокарты перфокарт перфокартами
ректор: ректор
бремя: бременем
стоить: стоить стоит
поменять: поменяли поменять
реклама: реклама
разнообразный: разнообразных
лишний: лишним
таможня: таможни
дождаться: дождаться
умаров: умаров
уважаемый: уважаемыми
блокчейн: блокчейна блокчейну
долгий: долгие
подавляться: подавляется
тетерев: тетерев
конфисковать: конфискованы
подвергать: подвергать
америка: америки
тестостерон: тестостерона тестостерон
гершензон: гершензон
оба: обеих оба обе
достигнуть: достигло достигнув
пик: пика
суверенный: суверенных
импорт: импорт импорта
присутствие: присутствие
я: мной
обрекать: обрекает
прочный: прочным
вырасти: выросли выросла вырос
купероза: куперозу
уголь: уголь
плательщик: плательщика
контрсанкция: контрсанкций
берроуз: берроуз
научить: научили
грандиозность: грандиозности
универсальность: универсальность
поговорить: поговорить
утром: утром
показатель: показателю
обновление: обновлений
круг: круги
бесплатно: бесплатно
сайт: сайта сайтах сайте
строго: строго
случиться: случилось случится случившемуся
египет: египет египте
территория: территориях территории
фотограф: фотограф
уходить: уходили
превышать: превышающие
минерал: минералы
фон: фоне
способный: способны
скорый: скорей
опись: описи
внутри: внутри
вопрос: вопросы вопросом вопрос вопросов
слабость: слабостью
подвергаться: подвергаться подвергаются
порой: порой
жетон: жетонов жетоны
соробан: соробаны
числиться: числится
чувствительный: чувствительной чувствительны
создать: создал
выставляться: выставлялись
ожидать: ожидала ожидали
наложить: наложенных
запрос: запрос
предупреждать: предупреждает
судить: судя
конвертация: конвертации
очешуесть: очешуевшие
приятный: приятнее
житель: жители жителей
бабло: бабла
сергей: сергей
курс: курсу
юанев: юаневых
россиянин: россиянах россияне россиянам
опция: опция
сплошной: сплошная
кризис: кризиса кризис
перераспределение: перераспределение
индия: индию
госдолг: госдолг
гипергидроза: гипергидроз
исчерпывающий: исчерпывающий
социальный: социальный
хеджироваться: хеджироваться
обязывать: обязывающего
группа: группы
автор: автор авторы автора
прочий: прочие
обнаруживаться: обнаруживается
отвращение: отвращение
отчёт: отчеты отчет
странно: странно
накладный: накладные
годовой: годовых
относительно: относительно
значительный: значительной значительная
практика: практике
бирка: бирок бирки
почувствовать: почувствовал
валюта: валют валюте валюту
эквайринг: эквайринг
томно: томно
утверждать: утверждать
италия: италию италии
подряд: подряд
дерма: дерма
уточнение: уточнения
свойственный: свойственна
земля: землю
устройство: устройство
творить: творит
ускорять: ускорял
пятёрка: пятерки
приватный: приватные приватной
каков: какова каковы
ценность: ценностей ценность
транзисторный: транзисторной
вместо: вместо
приобрести: приобрели
книжка: книжек
подруга: подруга
пост: поста
утверждение: утверждение
увидеть: увидеть увидели
дорогой: подороже дорогом
брать: брал берем брать
параметр: параметрам
незаметный: незаметная
продолжение: продолжение
либо: либо
повышение: повышение
осуществиться: осуществились
основный: основным основными
идеал: идеале
позвонить: позвонили
призвать: призванный
догадаться: догадаться
химический: химической
около: около ок
оборона: обороны
турбулентность: турбулентности
страница: страницы страница
вытеснить: вытеснив
холодно: холодно
безрисковой: безрисковую
сохранение: сохранение
вскоре: вскоре
просто: просто
прочить: прочим
духовный: духовный
отрисовка: отрисовка
выходить: выходить
инвестирование: инвестирования
реализовывать: реализовывать
вздыхать: вздыхают
автоматический: автоматического
руководитель: руководитель
соглашение: соглашение соглашений
поступление: поступлений
давление: давление
контроль: контроля контроль
подробный: подробную
вывести: вывести
некий: неких неким
скрываться: скрываться
улица: улицу
турция: турции турцию
восьмой: восьмого
безоговорочный: безоговорочный
региональный: региональной регионального
утомление: утомление
отмахиваться: отмахиваясь
совершенно: совершенно
модель: модель
инвентаризация: инвентаризацию
местный: местных
утомлять: утомляют
сближение: сближение сближения
напряжённость: напряженности
зотов: зотова
аппаратура: аппаратура
собрать: собрали
заплатить: заплатить
разработка: разработок разработки
пересчёт: пересчете
спешить: спешил
данный: данную данный
физиология: физиологии
зато: зато
записаться: записаться
итого: итого
обмен: обмен обмене обмену
конфиденциальный: конфиденциальную конфиденциальная
обобщение: обобщение
косвенно: косвенно
вероятность: вероятности вероятность
полупроводниковый: полупроводниковой
выпасть: выпала
кином: киномы
урегулирование: урегулирования
трешевымь: трешевыми
поэтому: поэтому
еда: еда
хитрый: хитрое
жертва: жертвой
дисклеймера: дисклеймер
лихтенштейн: лихтенштейн
ради: ради
месопотамия: месопотамии
прогноз: прогнозы
волокно: волокон
достигнутый: достигнутое
пластиковый: пластиковых
единица: единицы
временно: временно
пример: примере пример
извиниться: извинились
рука: руку
список: списком список списка
независимость: независимость
рабочий: рабочих
электромеханический: электромеханическое
развиваться: развиваться
взять: взяла возьмет
снаружи: снаружи
рассеяться: рассеялась
номинальный: номинальный
куча: куча кучи
образ: образом
пропускать: пропускают
безразличие: безразличие
весьма: весьма
эдинбургский: эдинбургский
обратиться: обратитесь
дисбаланс: дисбалансов
поселение: поселений
внимательный: внимательном
двойной: двойному двойной двойную
точка: точки
скандал: скандалов
больничный: больничным
новость: новость новостей
прозрачность: прозрачность
коренной: коренные
вторжение: вторжение
прототип: прототип прототипа
биржевой: биржевые
регулировать: регулировавших
подстраиваться: подстраиваться
уровень: уровень
дружба: дружбе дружба
взаимодополняемость: взаимодополняемости
протекционизм: протекционизм
рычаг: рычаги
горизонт: горизонту
традиционный: традиционные
морган: морган
приходиться: приходится
выделение: выделение
восток: восток востока
капитализация: капитализации капитализация
звонок: звонок
табулятор: табуляторов
следом: следом
пока: пока
состояться: состоялся
кредитор: кредиторами
северный: северного
двенадцать: двенадцати
степень: степени
закончиться: закончилась
танан: танана
вызывать: вызывает
изделие: изделия
перспектива: перспектива перспективе
контрагент: контрагентами
сообщить: сообщил сообщило
обеспечиваться: обеспечивается
надлежащий: надлежащего
отстаивание: отстаивание
журналист: журналисты
принести: принесенные
иначе: иначе
довольно: довольно
совершенный: совершенного
конфета: конфета
необходимый: необходима
лаборатория: лаборатории лаборатория
прогресс: прогресса
англия: англию
площадь: площадь
стартап: стартап
ответственность: ответственности
безопасность: безопасности
угроза: угрозу угроза
наоборот: наоборот
инвестировать: инвестировано инвестировать
возможный: возможны возможных
усугубляться: усугубляется
неравноправный: неравноправных
штаны: штаны
отнестись: отнесся
безлимитный: безлимитных
роснефть: роснефть
меняться: меняется
подписать: подписали подписал
инструмент: инструменты инструментов
наступать: наступает
саммит: саммит
возвращать: возвращать
себум: себума
истребитель: истребитель
конвертировать: конвертировать
пасовать: пасует
фермер: фермерами
урок: урок
сей: сих
запуск: запуска
сосредоточиться: сосредоточиться
некто: некто
удостовериться: удостовериться
ветка: ветку
ссылка: ссылки
свободно: свободно
разрываться: разрываться
собираться: собираетесь
сельскохозяйственный: сельскохозяйственной
нераскрытый: нераскрытым
логистика: логистику
рассмотрение: рассмотрении
наблюдать: наблюдаем
суз: суз
стейблкойный: стейблкойны
возделывать: возделывать
распиливать: распиливали
оттуда: оттуда
колометрический: колометрическими
вполне: вполне
комплектующие: комплектующих
вдвое: вдвое
эволюция: эволюцию
обычный: обычный
десятилетие: десятилетий
илья: илья
вели: вели
частый: чаще
умудриться: умудрился
принудительно: принудительно
ощущать: ощущает ощущаете
рассуждать: рассуждает
считаться: считается считалась
ооо: ооо
паренёк: паренек
ряд: ряд
мода: мода
твёрдый: твердых
форма: форме
гарантия: гарантий гарантии
денис: денис
блог: блоге
разблокировать: разблокировали
раздражать: раздражает
выполнять: выполняли
сбой: сбой
промышленный: промышленного
часы: часы
инициатива: инициативы инициативой
начаться: началась
ребята: ребята
доверие: доверия
красный: красный
помещать: помещали
польза: пользу
бесполезно: бесполезно
фиолетовый: фиолетовый
увеличение: увеличение
особый: особую
сделать: сделаем сделать
картина: картине
рассматривать: рассматривает рассматривать
ключ: ключи
гендерный: гендерные
учесть: учтены учтено
стела: стела
найти: найти
перевод: перевод переводов переводом
госконтракт: госконтрактах
пожар: пожар
осуждать: осуждали
прямо: прямо
согласиться: согласились
провал: провалом
добрый: доброго
олег: олег
киномами: киномами
заключаться: заключается
тайваньский: тайваньскую
аналитик: аналитиков аналитики
спорный: спорные
комплексный: комплексная
точный: точных
безграмотный: безграмотную
неизвестно: неизвестно
обменять: обменять
экономика: экономики экономик
обвинение: обвинению
нелёгкий: нелегкой
полагаться: полагаться
уведомить: уведомил уведомили
римский: римского римская римской
помощь: помощи
отторгнуть: отторгнута
посетить: посетил
премьер: премьер
майнить: майнить
союзник: союзника союзник
конкуренция: конкуренции
ничто: ничем
криптоиндустрия: криптоиндустрии
неконфронтационный: неконфронтационное
обойти: обошел
президент: президента президент
заявлять: заявлял
получение: получения
штат: штаты
текстиль: текстиль
опыт: опыта опыт опытом
мощный: мощная
размещать: размещал
убирать: убирает
ныне: ныне
предоставить: предоставил
быстро: быстро
именно: именно
поганый: поганая
режим: режиме
квартал: квартал
подключаться: подключаются
оттенок: оттенок
объяснимый: объяснимы
модератор: модераторы
разумеется: разумеется
спецоперация: спецоперация
так: т
одновременно: одновременно
внутренний: внутренние
графика: графика
пятка: пяток
ядерный: ядерным
налог: налоги
скрытый: скрытый
возвращение: возвращения
прочувствовать: прочувствовать
скорее: скорее
товарищ: товарища
хизер: хизер
ходить: ходят
раствориться: растворилась раствориться
слабоватый: слабовата
бесперебойный: бесперебойную
жизнеспособный: жизнеспособная
экспортировать: экспортировать экспортируемые
величина: величину
опустить: опустят
наличка: наличку
слепой: слепой
фаза: фаза
налоговый: налоговых налоговой
дизайн: дизайн
аналогичный: аналогичным
отметка: отметки
японский: японские
сверстница: сверстниц
десктопный: десктопные
блок: блоков
вечером: вечером
бельгия: бельгию
эксклюзивный: эксклюзивных
республика: республика республикой
нуль: нуля
автопродление: автопродление
регистр: регистры
металлический: металлическими
миллион: миллионов миллиона миллион
знаменитый: знамениты
орфография: орфография
подозрительный: подозрительным
революционный: революционный
март: марта
зафиксировать: зафиксировать
удобный: удобнее
лев: лев
среда: среды
прикрытие: прикрытие
кроме: кроме
уехать: уедешь
текущий: текущих текущей
хватать: хватало
египтянин: египтяне
введение: введения
мешать: мешает
недоразумение: недоразумением
переговорщик: переговорщик
народный: народного
возникновение: возникновения
фигура: фигурами
сосуд: сосудов
девазиня: девазини
преступный: преступным
закрыть: закрыть
улучшаться: улучшались
итак: итак
млн: млн
мировой: мировых
важно: важно
погашать: погашать
характер: характера
ссылаться: ссылаясь
поправка: поправкой
публикация: публикации
провоцировать: провоцирует
плотный: плотнее
нередко: нередко
упражнение: упражнение
потребоваться: потребовались потребуется
половой: полового половых
открыться: откроется
складываться: складывается
руб: руб
монета: монет монетам
оштрафовать: оштрафован
идеальный: идеальной
новинка: новинку
мелкий: мелких мелким
существование: существовании
украинский: украинские украинского
кредитка: кредитка
фотосессия: фотосессии
смена: смену
драгоценность: драгоценности
закрепить: закреплено
узбекистан: узбекистана
яндекс: яндекс
субъективный: субъективная
напряжение: напряжении
оборудование: оборудование оборудования
победа: победу
активировать: активировать
оно: оно
пластмасса: пластмассы
завтра: завтра
настороженно: настороженно
дешёвый: дешевыми
подтверждать: подтверждают
никто: никто
палочка: палочки
некуда: некуда
деловой: деловые
бронирование: бронирование
увенчаться: увенчались
трудоёмкость: трудоемкость
банкомат: банкомате
московский: московской
избежание: избежания
просить: просят
забирать: забирали
криптокошелёк: криптокошельки
проснуться: проснулся
спецслужба: спецслужбы
далее: далее
пищевой: пищевые
вводить: вводил
менее: менее
скушать: скушать
иран: ирана
цвет: цветом
лояльность: лояльности
геополитический: геополитической
крымский: крымская
завидовать: завидую
сначала: сначала
входящий: входящих
вычет: вычетов
хакер: хакером
временной: временных
связать: связаны
вечно: вечно
начислить: начислили начислить
мутить: мутил
десятилетка: десятилетка
представлять: представлял
подчёркивать: подчеркивали
светлый: светлое
формулировка: формулировкам формулировки
девушка: девушка
досрочно: досрочно
переслать: перешли
конкретно: конкретно
ход: ходе
закрепиться: закрепиться
ввести: ввели
организационный: организационный
предположим: предположим
лишь: лишь
виталий: виталий
свойство: свойство
заработок: заработка
редакция: редакции
призыв: призывом
вплоть: вплоть
четвёртый: четвертый
коллега: коллегами
караганов: караганов
импортный: импортная
массовый: массовый
подлинный: подлинной
век: века
менять: меняю
асеана: асеан
четыреста: четыреста
намного: намного
промокод: промокоду
достаточный: достаточные
цзэминь: цзэминь
разбор: разбору
досрочный: досрочном
пандемия: пандемии
деревянный: деревянными
пионер: пионерами
путь: путь
построение: построение
фонд: фондах
сдержанный: сдержанным
туманный: туманные
ежегодно: ежегодно
отнюдь: отнюдь
нормально: нормально
узкий: узкую
мара: мар
геополитика: геополитика
прояснить: прояснить
высоко: высоко
присутствовать: присутствовать
параллельный: параллельными
счетовод: счетоводов
правильный: правильную
математический: математическое
средневековый: средневековая
подразумевать: подразумеваете
увы: увы
заслуживать: заслуживают
марс: марса
вчерашний: вчерашнему
предназначить: предназначена
разница: разница
прошлый: прошлом
отписать: отписал
критически: критически
внезапно: внезапно
автоматически: автоматически
доступный: доступную
иерихон: иерихона
ширяев: ширяев
фокус: фокус
удобство: удобство
сомнительный: сомнительных
сравнивать: сравнивать
неоднократно: неоднократно
раскрытие: раскрытия
прекрасно: прекрасно
выявить: выявлено
франция: франции
добрососедство: добрососедстве
исключить: исключен
учёт: учетом учет
снчть: снчть
абак: абаками
обёртка: обертку
ввозить: ввозимой
бурение: бурение
прикинуть: прикинув
рамка: рамках
заложить: заложенных
качество: качестве
проезд: проезд
функция: функция
обозначать: обозначали обозначаемый
тодин: тодинов
архитектура: архитектура
таможенный: таможенное
исследование: исследованиями
придать: придать
каучук: каучук
ишаго: ишаго
скорость: скорость
снимать: снимающего
эквивалент: эквивалент
намереваться: намеревались
бедный: бедный
абака: абака абаки
централизовать: централизованными
сентябрь: сентября
расппа: распп
русский: русский
выясниться: выяснилось
совместный: совместном
длинный: длинные
нидерланды: нидерланды
осудить: осудить
пацан: пацаны
инфекционный: инфекционных
казахстан: казахстана казахстан
взамен: взамен
ндс: ндс
банкир: банкира
раздел: раздела раздел
цзян: цзян
балтика: балтика
контент: контента
виртуальный: виртуальной
нервный: нервные
август: августе
эйфория: эйфория
мощь: мощи
исследовать: исследуя
микроэлектроника: микроэлектроника
бензин: бензин
сохранить: сохранена
присматриваться: присматривались
обнаружить: обнаружила обнаружить
шрифт: шрифтом
детство: детстве
сопоставить: сопоставить
производить: производят производимую
наступление: наступления
распространить: распространенные
реакция: реакции
р: р
факт: факту
моральный: моральный
упор: упор
соседний: соседних
млрд: млрд
извинить: извините
сперва: сперва
газ: газ
минута: минуту
нарастить: нарастить
обратно: обратно
честной: честное
успокаивать: успокаивают
откуда: откуда
петров: петров
проработать: проработал
ениколоп: ениколопов
команда: командам
транснациональный: транснациональными
ес: ес
внутрь: внутрь
протест: протесты
касперский: касперского
причинный: причинное
пообедать: пообедать
сделка: сделка
малый: меньшую
анастасия: анастасия
исключительно: исключительно
давно: давно
напористый: напористым
отказ: отказ
объединить: объединить
специализироваться: специализирующаяся
сразу: сразу
район: районе
терять: терять
катастрофа: катастроф
кричащий: кричащий
перекрыть: перекрыть
ранее: ранее
односторонний: односторонние
расплывчатый: расплывчатым
дебет: дебетом
география: географии
сравнение: сравнению
максимум: максимума
памятник: памятники
признаться: признаюсь
тимур: тимур
настырный: настырные
подвести: подведенным
постепенно: постепенно
взглянуть: взглянуть
насоздавать: насоздавать
лично: лично
порекомендовать: порекомендовало
легко: легко
картонка: картонки
континент: континенте
фантик: фантики
утерять: утерянного
устать: уставший
зайти: зашла
неделя: недель
придерживаться: придерживаются
естественный: естественным
конструктивный: конструктивным
разрисовывать: разрисовывали
отчётность: отчетность
держать: держать
тройка: тройке
затем: затем
процедура: процедуру процедуры
тинькофф: тинькофф
заглянуть: заглянул
дистанционный: дистанционного
коучий: коуч
мероприятие: мероприятия мероприятиях
г: г
прибавлять: прибавлять
гардероб: гардероб
слышный: слышно
джон: джон
настроение: настроение
вырубка: вырубка
предсказуемость: предсказуемость
взвешивать: взвешивать
к: ко
месторождение: месторождений
запускать: запускает
запись: записи запись
логарифмический: логарифмическая
становиться: становится
специфический: специфические
расторгнуть: расторгнуть
связанный: связанные
ссудный: ссудные
помещаться: помещались
трубопровод: трубопроводу
готовить: готовить
асимметрия: асимметрия
всякий: всякий
клушина: клушин
частный: частными
транспортный: транспортную
отнимать: отнимать
ммм: ммм
раскладывать: раскладываем
ежедневный: ежедневные
берроуза: берроуза
делиться: делится
константин: константин
сирия: сирии
назад: назад
суаньпание: суаньпаньи
разбираться: разбираюсь
криптобудущее: криптобудущее
аудировать: аудирует
экспортироваться: экспортировались
очередь: очередь
естественно: естественно
испытывать: испытывать
вынести: вынес
внешний: внешней
невзирая: невзирая
определённый: определенные
относить: относить
надёжно: надежно
предпосылка: предпосылки
транспорт: транспорт
невозможно: невозможно
настроить: настроен
накопление: накопления
выйти: выйти
самостоятельно: самостоятельно
трое: троих
снизиться: снизился
потреблять: потребляемого потребляет
обработка: обработкой
затащить: затащить
ниже: ниже
единоразов: единоразовых
записывать: записывали
сползать: сползают
нелёгкая: нелегким
федерация: федерации
рейтинг: рейтингом
противостояние: противостоянии
недавно: недавно
стричь: стричь
обходить: обходить
канада: канаде
спустя: спустя
прога: проги
кукуха: кукуху
частность: частности
объединять: объединяет
прагматизм: прагматизм
вес: вес
раз: раза
привычный: привычных
неуклонный: неуклонному
долгосрочный: долгосрочные
капилляр: капилляров
обесценивать: обесценивая
двое: двоих
целый: целый
хозяйство: хозяйство
равный: равных
затрагивать: затрагивают
вилы: вилы
амбиция: амбиции
пиво: пиво
устанавливать: устанавливать
леонид: леонид
ненавидеть: ненавидимыми
знакомиться: знакомитесь
добавлять: добавлять
июль: июля
сводиться: сводится
короткий: короткий
сбп: сбп
февраль: февраля
иронично: иронично
нормальный: нормальные
лидерство: лидерство
стремиться: стремился
дмитрий: дмитрий
направлять: направляет
уезжать: уезжала
раздражаться: раздражаются
осязаемый: осязаемые
ухудшение: ухудшение
светлана: светлана
уникальный: уникальной
пакет: пакета
крайний: крайней
тотем: тотемы
видеозвонок: видеозвонок
долг: долг
зарегистрировать: зарегистрированная
включаться: включаются
далеко: далеко
прибыль: прибыль
мало: мало
равно: равно
просматриваться: просматривается
чжу: чжу
бриться: бриться
получатель: получателя
умножать: умножать
консультация: консультация
скриншот: скриншотами
зависимость: зависимость
считывать: считывало
арефьев: арефьев
